Media Countries

  Afghanistan: Afghanistan
  Albania: Albanie
  Algeria: Algérie
  American Samoa: Samoa américaines
  Andorra: Andorre
  Angola: Angola
  Anguilla: Anguilla
  Antarctica: Antarctique
  Antigua and Barbuda: Antigua-et-Barbuda
  Argentina: Argentine
  Armenia: Arménie
  Aruba: Aruba
  Australia: Australie
  Austria: Autriche
  Azerbaijan: Azerbaïdjan
  Bahamas: Bahamas
  Bahrain: Bahreïn
  Bangladesh: Bangladesh
  Barbados: Barbade
  Belarus: Biélorussie
  Belgium: Belgique
  Belize: Belize
  Benin: Bénin
  Bermuda: Bermudes
  Bhutan: Bhoutan
  Bolivia: Bolivie
  Bosnia and Herzegovina: Bosnie Herzégovine
  Botswana: Botswana
  Bouvet Island: Île Bouvet
  Brazil: Brésil
  Brunei Darussalam: Brunei Darussalam
  Bulgaria: Bulgarie
  Burkina Faso: Burkina Faso
  Burundi: Burundi
  Cambodia: Cambodge
  Cameroon: Cameroun
  Canada: Canada
  Cape Verde: Cap-Vert
  Cayman Islands: Îles Caïmans
  Central African Republic: République Centrafricaine
  Chad: Tchad
  Chile: Chili
  China: Chine
  Christmas Island: Christmas Island
  Cocos (Keeling) Islands: Cocos (Keeling)
  Colombia: Colombie
  Comoros: Comores
  Congo: Congo
  Cook Islands: Iles Cook
  Costa Rica: Costa Rica
  Cote D'ivoire: Côte D'ivoire
  Croatia: Croatie
  Cuba: Cuba
  Cyprus: Chypre
  Czech Republic: République Tchèque
  Denmark: Danemark
  Djibouti: Djibouti
  Dominica: Dominique
  Dominican Republic: République Dominicaine
  Ecuador: Equateur
  Egypt: Egypte
  El Salvador: Le Salvador
  Equatorial Guinea: Guinée Equatoriale
  Eritrea: Erythrée
  Estonia: Estonie
  Ethiopia: Ethiopie
  Falkland Islands : Iles Malouines
  Faroe Islands: Îles Féroé
  Fiji: Fidji
  Finland: Finlande
  France: France
  French Guiana: Guyane française
  French Polynesia: Polynésie française
  Gabon: Gabon
  Gambia: Gambie
  Georgia: Géorgie
  Germany: Allemagne
  Ghana: Ghana
  Gibraltar: Gibraltar
  Greece: Grèce
  Greenland: Groenland
  Grenada: Grenade
  Guadeloupe: Guadeloupe
  Guam: Guam
  Guatemala: Guatemala
  Guernsey: Guernesey
  Guinea: Guinée
  Guinea-bissau: Guinée-Bissau
  Guyana: Guyane
  Haiti: Haïti
  Heard and Mcdonald Islands: Îles Heard et McDonald
  Holy See (Vatican City State): Saint-Siège (Cité du Vatican)
  Honduras: Honduras
  Hong Kong: Hong Kong
  Hungary: Hongrie
  Iceland: Islande
  India: Inde
  Indonesia: Indonésie
  Iran, Islamic Republic of: Iran, République islamique d'
  Iraq: Irak
  Ireland: Irlande
  Isle of Man: Isle of Man
  Israel: Israël
  Italy: Italie
  Jamaica: Jamaïque
  Japan: Japon
  Jersey: Jersey
  Jordan: Jordanie
  Kazakhstan: Kazakhstan
  Kenya: Kenya
  Kiribati: Kiribati
  Korea, North: Corée du Nord
  Korea, Republic of: Corée, République de
  Kuwait: Koweit
  Kyrgyzstan: Kirghizstan
  Laos: Laos
  Latvia: Lettonie
  Lebanon: Liban
  Lesotho: Lesotho
  Liberia: Libéria
  Libyan Arab Jamahiriya: Jamahiriya arabe libyenne
  Liechtenstein: Liechtenstein
  Lithuania: Lituanie
  Luxembourg: Luxembourg
  Macao: Macao
  Macedonia: Macédoine
  Madagascar: Madagascar
  Malawi: Malawi
  Malaysia: Malaisie
  Maldives: Maldives
  Mali: Mali
  Malta: Malte
  Marshall Islands: Iles Marshall
  Martinique: Martinique
  Mauritania: Mauritanie
  Mauritius: Ile Maurice
  Mayotte: Mayotte
  Mexico: Mexique
  Micronesia: Micronésie
  Moldova: Moldova
  Monaco: Monaco
  Mongolia: Mongolie
  Montenegro: Monténégro
  Montserrat: Montserrat
  Morocco: Maroc
  Mozambique: Mozambique
  Myanmar: Myanmar
  Namibia: Namibie
  Nauru: Nauru
  Nepal: Népal
  Netherlands: Pays-Bas
  Netherlands Antilles: Antilles néerlandaises
  New Caledonia: Nouvelle-Calédonie
  New Zealand: Nouvelle Zélande
  Nicaragua: Nicaragua
  Niger: Niger
  Nigeria: Nigeria
  Niue: Niue
  Norfolk Island: Norfolk Island
  Northern Mariana Islands: Îles Mariannes du Nord
  Norway: Norvège
  Oman: Oman
  Pakistan: Pakistan
  Palau: Palau
  Palestinian Territories: Territoires palestiniens
  Panama: Panama
  Papua New Guinea: Papouasie Nouvelle Guinée
  Paraguay: Paraguay
  Peru: Pérou
  Philippines: Philippines
  Pitcairn: Pitcairn
  Poland: Pologne
  Portugal: Portugal
  Puerto Rico: Porto Rico
  Qatar: Qatar
  Reunion: Réunion
  Romania: Roumanie
  Russian Federation: Fédération Russe
  Rwanda: Rwanda
  Saint Helena: Saint Helena
  Saint Kitts and Nevis: Saint-Kitts-et-Nevis
  Saint Lucia: Sainte-Lucie
  Saint Pierre and Miquelon: Saint-Pierre-et-Miquelon
  Saint Vincent : Saint-Vincent-
  Samoa: Samoa
  San Marino: San Marino
  Sao Tome and Principe: Sao Tomé et Principe
  Saudi Arabia: Arabie Saoudite
  Senegal: Sénégal
  Serbia: Serbie
  Seychelles: Seychelles
  Sierra Leone: Sierra Leone
  Singapore: Singapour
  Slovakia: Slovaquie
  Slovenia: Slovénie
  Solomon Islands: Iles Salomon
  Somalia: Somalie
  South Africa: Afrique Du Sud
  Spain: Espagne
  Sri Lanka: Sri Lanka
  Sudan: Soudan
  Suriname: Suriname
  Svalbard and Jan Mayen: Svalbard et Jan Mayen
  Swaziland: Swaziland
  Sweden: Suède
  Switzerland: Suisse
  Syrian Arab Republic: République arabe syrienne
  Taiwan, province of China: Taiwan, province de Chine
  Tajikistan: Tadjikistan
  Tanzania: Tanzanie
  Thailand: Thaïlande
  Timor-leste: Timor-Leste
  Togo: Togo
  Tokelau: Tokelau
  Tonga: Tonga
  Trinidad and Tobago: Trinité-et-Tobago
  Tunisia: Tunisie
  Turkey: Dinde
  Turkmenistan: Turkménistan
  Turks and Caicos : Îles Turques et Caïques
  Tuvalu: Tuvalu
  Uganda: Ouganda
  Ukraine: Ukraine
  United Arab Emirates: Emirats Arabes Unis
  United Kingdom: Royaume-Uni
  United States: États Unis
  Uruguay: Uruguay
  Uzbekistan: Ouzbékistan
  Vanuatu: Vanuatu
  Venezuela: Venezuela
  Vietnam: Viêt-Nam
  Virgin Islands, British: Îles Vierges britanniques,
  Virgin Islands, U.S.: Îles Vierges américaines,
  Wallis and Futuna: Wallis et Futuna
  Western Sahara: Sahara Occidental
  Yemen: Yémen
  Zambia: Zambie
  Zimbabwe: Zimbabwe
