Schedules Menu

  Emergencies: 優先廣播

Emergency

  Heading: 優先廣播
  Instructions: 一個媒體項目拖到下面的表格來安排優先廣播。雙擊編輯條目。

  No Broadcasts: 有計劃在該球員沒有優先級廣播。

  Name: 名字
  Start: 開始
  Stop: 停止
  Frequency: 頻率
  Duration: 長短
  Media: 媒體

  Only Schedule One Item: 可以在一個時間安排只有一個項目。
  Playlist Not Supported: 不支持在這個時候優先廣播播放列表。
  Not Found: 找不到優先廣播。
  Required Field Missing: 一個或多個必填字段未填寫。
  Item Does Not Exist: 您正在嘗試編輯的項目似乎並不存在。
  Device Does Not Exist: 這款播放器似乎並不存在。
  Media Invalid: 這個媒體項是無效的。
  Media Not Approved: 媒體必須經過批准。
  Media Is Archived: 媒體不得歸檔。
  Frequency Invalid: 頻率是無效的。
  Duration Invalid: 的持續時間是無效的。
  Start DateTime Invalid: 開始日期/時間是無效的。
  Stop DateTime Invalid: 停止日期/時間無效。
  Stop Must Be After Start: 開始日期/時間後停止日期/時間必須發生。

Emergency Edit

  Heading: 優先廣播
  Media Item: 媒體項目
  Name: 名字
  Play Every: 每玩
  Seconds: 秒
  Image Duration: 圖片時間
  Minutes: 分鐘
  Start Date: 開始日期
  Start Time: 開始時間
  Stop Date: 截止日期
  Stop Time: 停止時間

  Delete Emergency Confirm: 你確定你要刪除這個優先廣播？
