Media Genres

  Yukon: 育空地區
  Classic Rock: 經典搖滾
  Country: 國家
  Disco: 迪斯科
  Funk: 恐懼
  Grunge: 垃圾
  Hip Hop: 嘻哈
  Jazz: 爵士樂
  Metal: 金屬
  New Age: 新時代
  Oldies: 懷舊
  Pop: 流行的
  RandB: RandB
  Rap: 敲擊
  Reggae: 雷鬼
  Rock: 岩
  Techno: TECHNO
  Misc: 雜項
  Trip Hop: 合之旅
  Asian-Pop: 亞洲流行
  Alternative Rock: 另類搖滾
  Electronic: 電子
  Pop Folk: 民間流行
  Eesti Pop: 愛沙尼亞流行
  Peru Folk: 秘魯民俗
  SoundTrack: 聲帶
  World Beat: 世界節拍
  Celtic: 塞爾特
  Soft Rock: 軟岩
  Ambient: 環境
  Native American: 美洲原住民
  Hard Rock: 硬石
  Progressive Rock: 前衛搖滾
  Primus: 博智
  Buddha Bar: 佛陀酒吧
  SFX: SFX
  Punk: 朋克
  Canadien Francais: 加拿大元語
  Landscape: 景觀
  Yellowknife: 耶洛奈夫
  Yellowknife: 耶洛奈夫
  Abstract: 抽象
  Adults: 成人
  Agriculture: 農業
  Americana: 美洲
  Animal: 動物
  Architecture: 架構
  Arts: 藝術
  AstroPhotography: 天文攝影
  Baby: 嬰兒
  Backgrounds: 背景
  Boy: 男孩
  Business: 業務
  Celebrations: 慶祝活動
  Children: 孩子們
  City: 城市
  Communications : 通訊
  Computers : 計算機
  Conceptual: 概念上的
  Couple: 對
  Culture: 文化
  Documentary: 記錄片
  Domestic: 國內
  Earth Photos: 地球照片
  Education: 教育
  Election: 選舉
  Entertainment: 娛樂
  Environmental: 環境的
  Families: 家庭
  Fantasy: 幻想
  Financial : 財政
  Fineart: FINEART
  Flowers: 花卉
  Food: 食品
  General: 一般
  Girl: 女孩
  Glamour: 魅力
  Government: 政府
  Health: 健康
  Historic: 歷史性
  Holidays: 假期
  Homes: 家園
  Humorous: 幽默
  Industrial: 產業
  International: 國際
  Landscapes: 景觀
  Leisure: 閒暇
  Lifestyles: 生活方式
  LoveRomance: LoveRomance
  Manufacturing: 製造業
  Medical: 醫
  Meetings : 會議
  Men : 男人
  Military: 軍事
  Models: 車型
  Money : 錢
  Music: 音樂
  Nature: 大自然
  Nautical: 海
  Newspaper: 報紙
  Northern: 北方
  Nostalgia: 懷舊之情
  Office : 辦公室
  Outdoors: 戶外
  Patriotic: 愛國
  Patterns: 圖案
  People : 人
  Personality: 個性
  Pets: 寵物
  PhotoEssay: PhotoEssay
  Political: 政治
  Portrait: 肖像
  Recreation: 娛樂
  Religion: 宗教
  Science: 科學
  Shopping: 購物
  Signs: 跡象
  SpacePhotos: SpacePhotos
  Sports: 體育
  StillLife: StillLife
  Symbols: 符號
  Teamwork : 合作
  Technology : 技術
  Textures: 紋理
  Tourism: 旅遊
  Traditional: 傳統
  Transportation: 運輸
  Travel : 旅遊
  Underwater: 水下
  Vintage: 葡萄收穫期
  Weather: 天氣
  Wildlife: 野生動物
  Women: 婦女
  Work and Workplace: 工作和工作場所
  XXX: XXX
  Action: 行動
  Adventure: 冒險
  Amateur: 業餘
  Animation: 動畫
  Biography: 傳記
  Blaxploitation: 利用黑人
  Chick Flicks: 小雞筆觸
  Christmas: 聖誕
  Classic Hollywood: 好萊塢經典
  Comedy: 喜劇
  Comic Book Based: 漫畫書基
  Crime: 犯罪
  Cult Movies: 邪教電影
  Detective Mystery Films: 偵探懸疑片
  Disaster Films: 災​​難電影
  Documentary: 記錄片
  Drama: 劇
  Experimental: 試驗
  Family: 家庭
  Fantasy: 幻想
  Film Noir: 黑色電影
  Game Show: 遊戲展
  History: 歷史
  Horror: 恐怖
  Martial Arts: 武術
  Miscellaneous: 雜項
  Mockumentary: 偽紀錄片
  Music Concerts: 音樂會
  Musical: 音樂
  News: 新聞
  Northern: 北方
  Organized Crime: 有組織犯罪
  Reality TV: 現實電視
  Road Films: 電影之路
  Romance: 浪漫
  Satire: 諷刺
  SciFi: 科幻
  Short: 短
  Silent Movies: 無聲電影
  Sport: 體育
  Supernatural Films: 靈異電影
  Talk Show: 脫口秀
  Teen Movies: 青少年電影
  Thrillers Suspense: 驚悚懸疑
  TrailersPreviews: TrailersPreviews
  War: 戰爭
  Western: 西
  XXX: XXX
  Blues: 藍調
  Folk: 民間
  Part of Complete Show: 成套表演的一部分
  Song/Media Intro: 宋/媒體簡介
  Song/Media Outro: 宋/媒體尾奏
  Show Intro: 展會簡介
  Show Outro: 展會尾奏
  Other: 其他
  CJUC Station ID: CJUC站ID
  CFET Station ID: CFET站ID
  Other Station ID: 其他站ID
  Show Promotion: 展會推廣
  News: 新聞
  Weather: 天氣
  Other: 其他
  Emergency Broadcast: 優先廣播
  Commercial Ad: 商業廣告
  Public Service Announcement: 公共服務公告
  Complete Shows: 完整的節目
  Other: 其他
  Alternative: 另類
  Alternative Country: 替代國
  House Music (Electro): 音樂房子（電）
  House Music (minimal): 眾議院音樂（最小）
  House Music (Tech): 眾議院音樂（科技）
  House Music (Deep): 眾議院音樂（深）
  House Music (prog): 眾議院音樂（PROG）
  Acoustic: 聲
  Experimental electronic: 實驗電子
  Indie: 獨立
  Chillwave-Lounge: Chillwave-休息室
  House Music: 樓音樂
  Dubtech: Dubtech
  Electro-Bassline-Filter: 電貝斯過濾
  Minimalism: 極簡主義
  Classical: 經典
  New Wave: 新浪潮
  Concert: 音樂會
  Mash-up: 混搭
  Dubstep: 的dubstep
  Movie Bits: 電影位
  OTR Vintage Commercials: OTR復古財經
  OTR Challenge: OTR挑戰
  OTR TV Themes: OTR電視主題
  Christmas Alt: 聖誕Alt鍵
  OTR Goon Show: OTR笨蛋展示
  Christmas: 聖誕
  Holiday: 節日
  ComedyFunny: ComedyFunny
  RA Podcasts: RA播客
  Moombahton: Moombahton
  Soul: 靈魂

