Media Genres

  Yukon: Yukon
  Classic Rock: Classic Rock
  Country: Land
  Disco: Disko
  Funk: Funk
  Grunge: Grunge
  Hip Hop: Hip Hop
  Jazz: Jazz
  Metal: Metall
  New Age: Neues Zeitalter
  Oldies: Oldies
  Pop: Pop
  RandB: RandB
  Rap: Rap
  Reggae: Reggae
  Rock: Rock
  Techno: Techno
  Misc: Sonstiges
  Trip Hop: Trip Hop
  Asian-Pop: Asian Pop-
  Alternative Rock: Alternative Rock
  Electronic: Elektronisch
  Pop Folk: Pop Volks
  Eesti Pop: Eesti Pop
  Peru Folk: Peru Folk
  SoundTrack: SoundTrack
  World Beat: World Beat
  Celtic: Keltisch
  Soft Rock: Soft Rock
  Ambient: Umgebungs-
  Native American: Indianer
  Hard Rock: Hardrock
  Progressive Rock: Progressive Rock
  Primus: Primus
  Buddha Bar: Buddha Bar
  SFX: SFX
  Punk: Punk
  Canadien Francais: Canadien Francais
  Landscape: Landschaft
  Yellowknife: Yellowknife
  Yellowknife: Yellowknife
  Abstract: Zusammenfassung
  Adults: Erwachsene
  Agriculture: Landwirtschaft
  Americana: Americana
  Animal: Tier
  Architecture: Architektur
  Arts: Künste
  AstroPhotography: Astrofotografie
  Baby: Baby
  Backgrounds: Hintergründe
  Boy: Junge
  Business: Unternehmen
  Celebrations: Feierlichkeiten
  Children: Kinder
  City: City
  Communications : Mitteilungen
  Computers : Computer
  Conceptual: Begrifflich
  Couple: Paar
  Culture: Kultur
  Documentary: Dokumentarfilm
  Domestic: Inländisch
  Earth Photos: Erde Fotos
  Education: Bildung
  Election: Wahl
  Entertainment: Unterhaltung
  Environmental: Umwelt-
  Families: Familien
  Fantasy: Fantasie
  Financial : Finanz-
  Fineart: Kunst
  Flowers: Blumen
  Food: Lebensmittel
  General: General
  Girl: Mädchen
  Glamour: Glamour
  Government: Regierung
  Health: Gesundheit
  Historic: Historisch
  Holidays: Ferien
  Homes: Homes
  Humorous: Humorvoll
  Industrial: Industriell
  International: International
  Landscapes: Landschaften
  Leisure: Freizeit
  Lifestyles: Lebensstil
  LoveRomance: LoveRomance
  Manufacturing: Herstellung
  Medical: Medizinische
  Meetings : Meetings
  Men : Men
  Military: Militär
  Models: Models
  Money : Geld
  Music: Musik
  Nature: Natur
  Nautical: Nautisch
  Newspaper: Zeitung
  Northern: Nord-
  Nostalgia: Nostalgie
  Office : Büro
  Outdoors: Im Freien
  Patriotic: Patriotisch
  Patterns: Patterns
  People : Menschen
  Personality: Persönlichkeit
  Pets: Haustiere
  PhotoEssay: Fotoessay
  Political: Politisch
  Portrait: Portrait
  Recreation: Erholung
  Religion: Religion
  Science: Wissenschaft
  Shopping: Einkaufen
  Signs: Signs
  SpacePhotos: SpacePhotos
  Sports: Sport
  StillLife: Stillleben
  Symbols: Symbole
  Teamwork : Zusammenspiel
  Technology : Technologie
  Textures: Textures
  Tourism: Tourismus
  Traditional: Traditionell
  Transportation: Transport
  Travel : Reise
  Underwater: Unterwasser-
  Vintage: Weinlese
  Weather: Wetter
  Wildlife: Tierwelt
  Women: Frauen
  Work and Workplace: Arbeit und Arbeitsplatz
  XXX: XXX
  Action: Aktion
  Adventure: Abenteuer
  Amateur: Amateur
  Animation: Animation
  Biography: Biografie
  Blaxploitation: Blaxploitation
  Chick Flicks: Chick Flicks
  Christmas: Weihnachten
  Classic Hollywood: Klassische Hollywood
  Comedy: Komödie
  Comic Book Based: Comic Based
  Crime: Verbrechen
  Cult Movies: Kultfilme
  Detective Mystery Films: Detective Geheimnis Films
  Disaster Films: Disaster Films
  Documentary: Dokumentarfilm
  Drama: Drama
  Experimental: Experimental-
  Family: Familie
  Fantasy: Fantasie
  Film Noir: Film Noir
  Game Show: Spielshow
  History: Geschichte
  Horror: Horror
  Martial Arts: Martial Arts
  Miscellaneous: Verschieden
  Mockumentary: Mockumentary
  Music Concerts: Musik Konzerte
  Musical: Musical
  News: Nachrichten
  Northern: Nord-
  Organized Crime: Organisiertes Verbrechen
  Reality TV: Reality-TV
  Road Films: Road Films
  Romance: Romantik
  Satire: Satire
  SciFi: SciFi
  Short: Kurz
  Silent Movies: Stummfilme
  Sport: Sport
  Supernatural Films: Supernatural Films
  Talk Show: Talkshow
  Teen Movies: Teen Movies
  Thrillers Suspense: Thrillers Suspense
  TrailersPreviews: TrailersPreviews
  War: Krieg
  Western: Western
  XXX: XXX
  Blues: Blues
  Folk: Leute
  Part of Complete Show: Ein Teil der komplette anzeigen
  Song/Media Intro: Song / Media-Intro
  Song/Media Outro: Song / Medien Outro
  Show Intro: Show Intro
  Show Outro: Show Outro
  Other: Andere
  CJUC Station ID: CJUC Stations-ID
  CFET Station ID: CFET Stations-ID
  Other Station ID: Andere Station ID
  Show Promotion: Promotion anzeigen
  News: Nachrichten
  Weather: Wetter
  Other: Andere
  Emergency Broadcast: Priority Broadcast-
  Commercial Ad: Kommerzielle Ad
  Public Service Announcement: Öffentliche Bekanntmachung
  Complete Shows: Komplette Shows
  Other: Andere
  Alternative: Alternative
  Alternative Country: Alternative Country
  House Music (Electro): House Music (Electro)
  House Music (minimal): House Music (minimal)
  House Music (Tech): House Music (Tech)
  House Music (Deep): House Music (Deep)
  House Music (prog): House Music (PROG)
  Acoustic: Akustisch
  Experimental electronic: Experimentelle elektronische
  Indie: Indie
  Chillwave-Lounge: Chillwave-Lounge
  House Music: House Music
  Dubtech: Dubtech
  Electro-Bassline-Filter: Electro-Bassline-Filter
  Minimalism: Minimalismus
  Classical: Klassik
  New Wave: New Wave
  Concert: Konzert
  Mash-up: Vermischen
  Dubstep: Dubstep
  Movie Bits: Film-Bits
  OTR Vintage Commercials: OTR-Weinlese-Werbung
  OTR Challenge: OTR Herausforderung
  OTR TV Themes: OTR TV Themes
  Christmas Alt: Weihnachten Alt
  OTR Goon Show: OTR Goon Show
  Christmas: Weihnachten
  Holiday: Urlaub
  ComedyFunny: ComedyFunny
  RA Podcasts: RA Podcasts
  Moombahton: Moombahton
  Soul: Seele

