Media Countries

  Afghanistan: Afghanistan
  Albania: Albanien
  Algeria: Algerien
  American Samoa: Amerikanische Samoa
  Andorra: Andorra
  Angola: Angola
  Anguilla: Anguilla
  Antarctica: Antarktika
  Antigua and Barbuda: Antigua und Barbuda
  Argentina: Argentinien
  Armenia: Armenien
  Aruba: Aruba
  Australia: Australien
  Austria: Österreich
  Azerbaijan: Aserbaidschan
  Bahamas: Bahamas
  Bahrain: Bahrein
  Bangladesh: Bangladesch
  Barbados: Barbados
  Belarus: Weißrussland
  Belgium: Belgien
  Belize: Belize
  Benin: Benin
  Bermuda: Bermuda
  Bhutan: Bhutan
  Bolivia: Bolivien
  Bosnia and Herzegovina: Bosnien und Herzegowina
  Botswana: Botswana
  Bouvet Island: Bouvet-Insel
  Brazil: Brasilien
  Brunei Darussalam: Brunei Darussalam
  Bulgaria: Bulgarien
  Burkina Faso: Burkina Faso
  Burundi: Burundi
  Cambodia: Kambodscha
  Cameroon: Kamerun
  Canada: Kanada
  Cape Verde: Kap Verde
  Cayman Islands: Cayman Islands
  Central African Republic: Zentralafrikanische Republik
  Chad: Tschad
  Chile: Chile
  China: China
  Christmas Island: Weihnachtsinsel
  Cocos (Keeling) Islands: Cocos (Keeling) Islands
  Colombia: Kolumbien
  Comoros: Komoren
  Congo: Kongo
  Cook Islands: Cook Islands
  Costa Rica: Costa Rica
  Cote D'ivoire: Elfenbeinküste
  Croatia: Kroatien
  Cuba: Kuba
  Cyprus: Zypern
  Czech Republic: Tschechische Republik
  Denmark: Dänemark
  Djibouti: Djibouti
  Dominica: Dominica
  Dominican Republic: Dominikanische Republik
  Ecuador: Ecuador
  Egypt: Ägypten
  El Salvador: El Salvador
  Equatorial Guinea: Äquatorialguinea
  Eritrea: Eritrea
  Estonia: Estland
  Ethiopia: Äthiopien
  Falkland Islands : Falkland-Inseln
  Faroe Islands: Färöer Inseln
  Fiji: Fiji
  Finland: Finnland
  France: Frankreich
  French Guiana: Französisch-Guayana
  French Polynesia: Französisch-Polynesien
  Gabon: Gabon
  Gambia: Gambia
  Georgia: Georgia
  Germany: Deutschland
  Ghana: Ghana
  Gibraltar: Gibraltar
  Greece: Griechenland
  Greenland: Grönland
  Grenada: Grenada
  Guadeloupe: Guadeloupe
  Guam: Guam
  Guatemala: Guatemala
  Guernsey: Guernsey
  Guinea: Guinea
  Guinea-bissau: Guinea-Bissau
  Guyana: Guyana
  Haiti: Haiti
  Heard and Mcdonald Islands: Heard und McDonald-Inseln
  Holy See (Vatican City State): Heiliger Stuhl (Vatikanstadt)
  Honduras: Honduras
  Hong Kong: Hong Kong
  Hungary: Ungarn
  Iceland: Island
  India: Indien
  Indonesia: Indonesien
  Iran, Islamic Republic of: Iran, Islamic Republic of
  Iraq: Irak
  Ireland: Irland
  Isle of Man: Isle of Man
  Israel: Israel
  Italy: Italien
  Jamaica: Jamaika
  Japan: Japan
  Jersey: Jersey
  Jordan: Jordan
  Kazakhstan: Kasachstan
  Kenya: Kenia
  Kiribati: Kiribati
  Korea, North: Nordkorea
  Korea, Republic of: Korea, Republic of
  Kuwait: Kuwait
  Kyrgyzstan: Kirgisistan
  Laos: Laos
  Latvia: Lettland
  Lebanon: Libanon
  Lesotho: Lesotho
  Liberia: Liberia
  Libyan Arab Jamahiriya: Libyan Arab Jamahiriya
  Liechtenstein: Liechtenstein
  Lithuania: Litauen
  Luxembourg: Luxemburg
  Macao: Macao
  Macedonia: Mazedonien
  Madagascar: Madagaskar
  Malawi: Malawi
  Malaysia: Malaysia
  Maldives: Malediven
  Mali: Mali
  Malta: Malta
  Marshall Islands: Marshall Islands
  Martinique: Martinique
  Mauritania: Mauretanien
  Mauritius: Mauritius
  Mayotte: Mayotte
  Mexico: Mexiko
  Micronesia: Mikronesien
  Moldova: Moldawien
  Monaco: Monaco
  Mongolia: Mongolei
  Montenegro: Montenegro
  Montserrat: Montserrat
  Morocco: Marokko
  Mozambique: Mosambik
  Myanmar: Myanmar
  Namibia: Namibia
  Nauru: Nauru
  Nepal: Nepal
  Netherlands: Niederlande
  Netherlands Antilles: Niederländische Antillen
  New Caledonia: Neu-Kaledonien
  New Zealand: Neuseeland
  Nicaragua: Nicaragua
  Niger: Niger
  Nigeria: Nigeria
  Niue: Niue
  Norfolk Island: Norfolkinsel
  Northern Mariana Islands: Northern Mariana Islands
  Norway: Norwegen
  Oman: Oman
  Pakistan: Pakistan
  Palau: Palau
  Palestinian Territories: Palästinensische Gebiete
  Panama: Panama
  Papua New Guinea: Papua-Neuguinea
  Paraguay: Paraguay
  Peru: Peru
  Philippines: Philippinen
  Pitcairn: Pitcairn
  Poland: Polen
  Portugal: Portugal
  Puerto Rico: Puerto Rico
  Qatar: Katar
  Reunion: Wiedervereinigung
  Romania: Rumänien
  Russian Federation: Russische Föderation
  Rwanda: Ruanda
  Saint Helena: St. Helena
  Saint Kitts and Nevis: St. Kitts und Nevis
  Saint Lucia: St. Lucia
  Saint Pierre and Miquelon: St. Pierre und Miquelon
  Saint Vincent : St. Vincent
  Samoa: Samoa
  San Marino: San Marino
  Sao Tome and Principe: Sao Tome und Principe
  Saudi Arabia: Saudi-Arabien
  Senegal: Senegal
  Serbia: Serbien
  Seychelles: Seychellen
  Sierra Leone: Sierra Leone
  Singapore: Singapur
  Slovakia: Slowakei
  Slovenia: Slowenien
  Solomon Islands: Salomon-Inseln
  Somalia: Somalia
  South Africa: Südafrika
  Spain: Spanien
  Sri Lanka: Sri Lanka
  Sudan: Sudan
  Suriname: Suriname
  Svalbard and Jan Mayen: Svalbard und Jan Mayen
  Swaziland: Swaziland
  Sweden: Schweden
  Switzerland: Schweiz
  Syrian Arab Republic: Arabische Republik Syrien
  Taiwan, province of China: Taiwan, Provinz von China
  Tajikistan: Tadschikistan
  Tanzania: Tansania
  Thailand: Thailand
  Timor-leste: Timor-Leste
  Togo: Gehen
  Tokelau: Tokelau
  Tonga: Tonga
  Trinidad and Tobago: Trinidad und Tobago
  Tunisia: Tunesien
  Turkey: Truthahn
  Turkmenistan: Turkmenistan
  Turks and Caicos : Turks- und Caicosinseln
  Tuvalu: Tuvalu
  Uganda: Uganda
  Ukraine: Ukraine
  United Arab Emirates: Vereinigte Arabische Emirate
  United Kingdom: Vereinigtes Königreich
  United States: Vereinigte Staaten
  Uruguay: Uruguay
  Uzbekistan: Usbekistan
  Vanuatu: Vanuatu
  Venezuela: Venezuela
  Vietnam: Vietnam
  Virgin Islands, British: Britische Jungferninseln
  Virgin Islands, U.S.: Virgin Islands, US-
  Wallis and Futuna: Wallis und Futuna
  Western Sahara: Westsahara
  Yemen: Jemen
  Zambia: Sambia
  Zimbabwe: Zimbabwe
