Account Login

  Password Incorrect: Salasõna, mida on esitanud vale.
  Heading: Konto Sisene
  Automatically Logged Out: Sa olid automaatselt sisse logitud välja pärast teatud tegevusetust. Palun logi uuesti enne jätkamist.
  Username: Kasutajanimi
  Password: Salasõna
  Log In Button: Logi sisse
  Log In Different User Button: Logi sisse teise kasutajana

Account Settings

  Form Heading: Konto seaded
  Form Help: Muuda järgmised konto seaded nii nagu vaja. Ainult sisestage parool, kui soovite, et muuta oma salasõna.

  Account Section: Konto

  Username: Kasutajanimi
  Name: Nimi
  Display Name: kuvatav nimi
  Password: Uus parool
  Password Again: Uus parool (jälle)
  Email: E-

  UI Section: Kasutajaliides

  Search Results Per Page: Otsing Tulemusi lehel

  Language: Keel

  Theme: Teema
  Light On Dark (Lower Contrast): Light Dark (Alam-Contrast)
  Dark On Light (Lower Contrast): Tume Light (Alam-Contrast)
  Light On Dark (Higher Contrast): Light Dark (Higher Contrast)
  Dark On Light (Higher Contrast): Tume Light (Higher Contrast)
  Tanzanite: Tanzanite

  Dyslexia-Friendly Font: Düsleksia Font
  Enabled Option: Lubatud
  Disabled Option: Invaliidistunud

  Settings Updated: Seaded on uuendatud. Kasutajaliides seadete muutmist peate võib-olla värskendama taotluse rakendada.

  Required Fields Not Filled: Üks või mitu nõutud väljad ei täidetud.
  Email Address Invalid: E-posti aadress on ette ei kehti.
  Email Address In Use: E-posti aadress on andnud juba kasutusel teise konto.
  Passwords Do Not Match: Paroolid on ette ei sobi.
  Password Not Long Enough: Parool peab olema vähemalt 6 tähemärki pikk.
  Language Not Valid: Valitud keeles ei kehti.
  Theme Not Valid: Teemaks on valitud ei kehti.

Account Menu

  Account: Konto
  Logout: Logi välja
  Settings: Konto seaded

Layout

  Logged In As: Sisse loginud: %1
