Schedules Menu

  Emergencies: prioriteet saated

Emergency

  Heading: prioriteet saated
  Instructions: Lohista meedia elemendi allolevas tabelis ajastada prioriteet saade. Topeltklõpsake kirjet redigeerida.

  No Broadcasts: Puuduvad prioriteet saateid kavas seda mängija.

  Name: Nimi
  Start: Algus
  Stop: Peatuge
  Frequency: Sagedus
  Duration: Kestus
  Media: Andmekandja

  Only Schedule One Item: Võite kavandada ainult üks ese korraga.
  Playlist Not Supported: Prioriteet saade loendeid ei toetata.
  Not Found: Prioriteet saade ei leitud.
  Required Field Missing: Üks või mitu nõutud väljad ei täidetud.
  Item Does Not Exist: Objekt, mida üritatakse muuta ei näi olevat.
  Device Does Not Exist: See mängija ei ole olemas.
  Media Invalid: See meedia objekt on kehtetu.
  Media Not Approved: Meedia peab heaks.
  Media Is Archived: Meedia ei tohi arhiveeritud.
  Frequency Invalid: Sagedus on kehtetu.
  Duration Invalid: Kestus on kehtetu.
  Start DateTime Invalid: Alguskuupäev / kellaaeg on vale.
  Stop DateTime Invalid: Stop kuupäev / kellaaeg on vale.
  Stop Must Be After Start: Stop kuupäev / aeg peab toimuma pärast alguskuupäev / kellaaeg.

Emergency Edit

  Heading: prioriteet saade
  Media Item: Meedia toode
  Name: Nimi
  Play Every: Mängi iga
  Seconds: sekundit
  Image Duration: Image Kestus
  Minutes: protokoll
  Start Date: alguskuupäev
  Start Time: algusaeg
  Stop Date: stop kuupäev
  Stop Time: lõppaeg

  Delete Emergency Confirm: Olete kindel, et soovite kustutada selle prioriteedi saade?
