Media Countries

  Afghanistan: Afganistan
  Albania: Albaania
  Algeria: Alžeeria
  American Samoa: Ameerika Samoa
  Andorra: Andorra
  Angola: Angola
  Anguilla: Anguilla
  Antarctica: Antarktis
  Antigua and Barbuda: Antigua ja Barbuda
  Argentina: Argentina
  Armenia: Armeenia
  Aruba: Aruba
  Australia: Austraalia
  Austria: Austria
  Azerbaijan: Aserbaidžaan
  Bahamas: Bahama
  Bahrain: Bahrain
  Bangladesh: Bangladesh
  Barbados: Barbados
  Belarus: Valgevene
  Belgium: Belgia
  Belize: Belize
  Benin: Benin
  Bermuda: Bermuda
  Bhutan: Bhutan
  Bolivia: Boliivia
  Bosnia and Herzegovina: Bosnia ja Hertsegoviina
  Botswana: Botswana
  Bouvet Island: Bouvet'saar
  Brazil: Brasiilia
  Brunei Darussalam: Brunei
  Bulgaria: Bulgaaria
  Burkina Faso: Burkina Faso
  Burundi: Burundi
  Cambodia: Kambodža
  Cameroon: Kamerun
  Canada: Kanada
  Cape Verde: Cape Verde
  Cayman Islands: Cayman Islands
  Central African Republic: Kesk-Aafrika Vabariik
  Chad: Chad
  Chile: Tšiili
  China: Hiina
  Christmas Island: Christmas Island
  Cocos (Keeling) Islands: Cocos (Keeling) Islands
  Colombia: Kolumbia
  Comoros: Komoorid
  Congo: Kongo
  Cook Islands: Cook Islands
  Costa Rica: Costa Rica
  Cote D'ivoire: Elevandiluurannik
  Croatia: Horvaatia
  Cuba: Kuuba
  Cyprus: Küpros
  Czech Republic: Tšehhi
  Denmark: Taani
  Djibouti: Djibouti
  Dominica: Dominica
  Dominican Republic: Dominikaani Vabariik
  Ecuador: Ecuador
  Egypt: Egiptus
  El Salvador: El Salvador
  Equatorial Guinea: Ekvatoriaal-Guinea
  Eritrea: Eritrea
  Estonia: Eesti
  Ethiopia: Etioopia
  Falkland Islands : Falklandi saared
  Faroe Islands: Fääri saared
  Fiji: Fidži
  Finland: Soome
  France: Prantsusmaa
  French Guiana: Prantsuse Guajaana
  French Polynesia: Prantsuse Polüneesia
  Gabon: Gabon
  Gambia: Gambia
  Georgia: Georgia
  Germany: Saksamaa
  Ghana: Ghana
  Gibraltar: Gibraltar
  Greece: Kreeka
  Greenland: Gröönimaa
  Grenada: Grenada
  Guadeloupe: Guadeloupe
  Guam: Guam
  Guatemala: Guatemala
  Guernsey: Guernsey
  Guinea: Guinea
  Guinea-bissau: Guinea-Bissau
  Guyana: Guyana
  Haiti: Haiti
  Heard and Mcdonald Islands: Heard ja McDonald
  Holy See (Vatican City State): Püha Tool (Vatikani Linnriik)
  Honduras: Honduras
  Hong Kong: Hong Kong
  Hungary: Ungari
  Iceland: Island
  India: India
  Indonesia: Indoneesia
  Iran, Islamic Republic of: Iran, Islamic Republic of
  Iraq: Iraak
  Ireland: Iirimaa
  Isle of Man: Isle of Man
  Israel: Iisrael
  Italy: Itaalia
  Jamaica: Jamaica
  Japan: Jaapan
  Jersey: Jersey
  Jordan: Jordaania
  Kazakhstan: Kasahstan
  Kenya: Kenya
  Kiribati: Kiribati
  Korea, North: Korea, Põhja
  Korea, Republic of: Lõuna-Korea
  Kuwait: Kuveit
  Kyrgyzstan: Kõrgõzstan
  Laos: Laos
  Latvia: Läti
  Lebanon: Liibanon
  Lesotho: Lesotho
  Liberia: Libeeria
  Libyan Arab Jamahiriya: Libyan Arab Jamahiriya
  Liechtenstein: Liechtenstein
  Lithuania: Leedu
  Luxembourg: Luxembourg
  Macao: Macao
  Macedonia: Makedoonia
  Madagascar: Madagaskar
  Malawi: Malawi
  Malaysia: Malaisia
  Maldives: Maldiivid
  Mali: Mali
  Malta: Malta
  Marshall Islands: Marshall Islands
  Martinique: Martinique
  Mauritania: Mauritaanias
  Mauritius: Mauritius
  Mayotte: Mayotte
  Mexico: Mehhiko
  Micronesia: Mikroneesia
  Moldova: Moldova
  Monaco: Monaco
  Mongolia: Mongoolia
  Montenegro: Montenegro
  Montserrat: Montserrat
  Morocco: Maroko
  Mozambique: Mosambiik
  Myanmar: Myanmar
  Namibia: Namiibia
  Nauru: Nauru
  Nepal: Nepal
  Netherlands: Holland
  Netherlands Antilles: Hollandi Antillid
  New Caledonia: Uus-Kaledoonia
  New Zealand: Uus-Meremaa
  Nicaragua: Nicaragua
  Niger: Niger
  Nigeria: Nigeeria
  Niue: Niue
  Norfolk Island: Norfolk Island
  Northern Mariana Islands: Põhja-Mariaanid
  Norway: Norra
  Oman: Oman
  Pakistan: Pakistan
  Palau: Palau
  Palestinian Territories: Palestiina aladel
  Panama: Panama
  Papua New Guinea: Paapua Uus-Guinea
  Paraguay: Paraguai
  Peru: Peruu
  Philippines: Filipiinid
  Pitcairn: Pitcairn
  Poland: Poola
  Portugal: Portugal
  Puerto Rico: Puerto Rico
  Qatar: Qatar
  Reunion: Kokkutulek
  Romania: Rumeenia
  Russian Federation: Venemaa
  Rwanda: Rwanda
  Saint Helena: Saint Helena
  Saint Kitts and Nevis: Saint Kitts ja Nevis
  Saint Lucia: Saint Lucia
  Saint Pierre and Miquelon: Saint-Pierre ja Miquelon
  Saint Vincent : Saint Vincent
  Samoa: Samoa
  San Marino: San Marino
  Sao Tome and Principe: Sao Tome ja Principe
  Saudi Arabia: Saudi Araabias
  Senegal: Senegal
  Serbia: Serbia
  Seychelles: Seišellid
  Sierra Leone: Sierra Leone
  Singapore: Singapur
  Slovakia: Slovakkia
  Slovenia: Sloveenia
  Solomon Islands: Saalomoni Saarte
  Somalia: Somaalia
  South Africa: Lõuna-Aafrika Vabariik
  Spain: Hispaania
  Sri Lanka: Sri Lanka
  Sudan: Sudaan
  Suriname: Suriname
  Svalbard and Jan Mayen: Svalbard ja Jan Mayen
  Swaziland: Svaasimaa
  Sweden: Rootsi
  Switzerland: Šveits
  Syrian Arab Republic: Süüria
  Taiwan, province of China: Taiwan, Hiina provints
  Tajikistan: Tadžikistan
  Tanzania: Tansaania
  Thailand: Tai
  Timor-leste: Ida-Timori
  Togo: Togo
  Tokelau: Tokelau
  Tonga: Tonga
  Trinidad and Tobago: Trinidad ja Tobago
  Tunisia: Tuneesia
  Turkey: Türgi
  Turkmenistan: Turkmenistan
  Turks and Caicos : Turks ja Caicos
  Tuvalu: Tuvalu
  Uganda: Uganda
  Ukraine: Ukraina
  United Arab Emirates: Araabia Ühendemiraadid
  United Kingdom: Suurbritannia
  United States: Ameerika Ühendriigid
  Uruguay: Uruguay
  Uzbekistan: Usbekistan
  Vanuatu: Vanuatu
  Venezuela: Venetsueela
  Vietnam: Vietnam
  Virgin Islands, British: Briti Neitsisaared
  Virgin Islands, U.S.: Neitsisaared, USA
  Wallis and Futuna: Wallis ja Futuna
  Western Sahara: Lääne-Sahara
  Yemen: Jeemen
  Zambia: Zambia
  Zimbabwe: Zimbabwe
