Advanced Search
    Heading: Advanced Search
    Edit Heading: Edit Advanced Search
    Search Criteria: Search Criteria

    Search Description: Search Description
    Search Description Instructions: Enter a search description to display instead of the search filter list (optional).

    Search Criteria Instructions: Add criteria using the above form.

My Searches
    Instructions: Click to search again.  Right-click for more options.
    Heading: Saved Searches
    Search History Heading: Search History
    No Searches: No searches found.

    Make Default: Make Default
    Unset Default: Unset Default

Sidebar
    Enter Search Query: (enter search query)
    Advanced Search Query: (advanced mode)

    Media Player: Media Player
    Media: Media
    Playlists: Playlists
    advanced: advanced
    simple: simple
    my searches: my searches

    My Filter Link: my
    Approved Filter Link: ap
    Unapproved Filter Link: un
    Archived Filter Link: ar

    Video Search Symbol: v
    Image Search Symbol: i
    Audio Search Symbol: a

    Artist: Artist
    Album/Series: Album/Series
    Title: Title
    Year: Year
    Category: Category
    Genre: Genre
    Country: Country
    Language: Language
    Time: Time
    Name: Name
    Description: Description

    Loading: Loading...
    more: more
    less: less
    previous: previous
    next: next

    Media Items Found: %1 media items found
    Media Item Found: 1 media item found

    No Media Found: No Media Found
    No Playlists Found: No Playlists Found

    Playlist Found: 1 playlist found
    Playlists Found: %1 playlists found

