Schedules Menu

  Emergencies: ออกอากาศลำดับความสำคัญ

Emergency

  Heading: ออกอากาศลำดับความสำคัญ
  Instructions: ลากรายการสื่อลงในตารางด้านล่างเพื่อจัดลำดับความสำคัญตารางออกอากาศ ดับเบิลคลิกที่รายการที่จะแก้ไข

  No Broadcasts: ไม่มีการออกอากาศความสำคัญที่กำหนดไว้สำหรับผู้เล่นนี้

  Name: ชื่อ
  Start: เริ่มต้น
  Stop: หยุด
  Frequency: ความถี่
  Duration: ระยะเวลา
  Media: สื่อ

  Only Schedule One Item: คุณสามารถกำหนดเวลาเพียงหนึ่งรายการในเวลา
  Playlist Not Supported: ลำดับความสำคัญการออกอากาศรายการเพลงไม่ได้สนับสนุนในขณะนี้
  Not Found: ออกอากาศลำดับความสำคัญไม่พบ
  Required Field Missing: หนึ่งหรือมากกว่าหนึ่งสาขาที่จำเป็นต้องได้รับไม่เต็ม
  Item Does Not Exist: รายการที่คุณกำลังพยายามที่จะแก้ไขไม่ปรากฏอยู่
  Device Does Not Exist: เครื่องเล่นนี้ไม่ปรากฏอยู่
  Media Invalid: รายการนี​​้เป็นสื่อที่ไม่ถูกต้อง
  Media Not Approved: สื่อจะต้องได้รับการอนุมัติ
  Media Is Archived: สื่อจะต้องไม่ถูกเก็บไว้
  Frequency Invalid: ความถี่ไม่ถูกต้อง
  Duration Invalid: ระยะเวลาที่ไม่ถูกต้อง
  Start DateTime Invalid: วันที่เริ่มต้น / ครั้งไม่ถูกต้อง
  Stop DateTime Invalid: วันหยุด / ครั้งไม่ถูกต้อง
  Stop Must Be After Start: วันหยุด / เวลาที่จะต้องเกิดขึ้นหลังจากวันที่เริ่มต้นที่ / เวลา

Emergency Edit

  Heading: ออกอากาศลำดับความสำคัญ
  Media Item: สื่อรายการ
  Name: ชื่อ
  Play Every: เล่นทุกคน
  Seconds: วินาที
  Image Duration: ภาพที่ระยะเวลา
  Minutes: นาที
  Start Date: วันที่เริ่มต้น
  Start Time: เวลา
  Stop Date: หยุดวันที่
  Stop Time: หยุดเวลา

  Delete Emergency Confirm: คุณแน่ใจว่าคุณต้องการลบออกอากาศลำดับความสำคัญนี้หรือไม่?
