Media Countries

  Afghanistan: อัฟกานิสถาน
  Albania: แอลเบเนีย
  Algeria: ประเทศแอลจีเรีย
  American Samoa: อเมริกันซามัว
  Andorra: อันดอร์รา
  Angola: แองโกลา
  Anguilla: แองกวิลลา
  Antarctica: ทวิปแอนตาร์กติกา
  Antigua and Barbuda: แอนติกาและบาร์บูดา
  Argentina: อาร์เจนตินา
  Armenia: อาร์เมเนีย
  Aruba: อารูบา
  Australia: ออสเตรเลีย
  Austria: ออสเตรีย
  Azerbaijan: อาเซอร์ไบจาน
  Bahamas: บาฮามาส
  Bahrain: บาห์เรน
  Bangladesh: บังคลาเทศ
  Barbados: บาร์เบโดส
  Belarus: เบลารุส
  Belgium: ประเทศเบลเยียม
  Belize: เบลีซ
  Benin: ประเทศเบนิน
  Bermuda: เบอร์มิวดา
  Bhutan: ภูฏาน
  Bolivia: ประเทศโบลิเวีย
  Bosnia and Herzegovina: บอสเนียและเฮอร์เซโก
  Botswana: บอตสวานา
  Bouvet Island: เกาะบูเวต
  Brazil: บราซิล
  Brunei Darussalam: บรูไนดารุสซาลาม
  Bulgaria: บัลแกเรีย
  Burkina Faso: บูร์กินาฟาโซ
  Burundi: บุรุนดี
  Cambodia: ประเทศกัมพูชา
  Cameroon: แคเมอรูน
  Canada: แคนาดา
  Cape Verde: เคปเวิร์ด
  Cayman Islands: หมู่เกาะเคย์แมน
  Central African Republic: สาธารณรัฐแอฟริกากลาง
  Chad: ชาด
  Chile: ชิลี
  China: ประเทศจีน
  Christmas Island: เกาะคริสต์มาส
  Cocos (Keeling) Islands: โคโคส (คีลิง) หมู่เกาะ
  Colombia: โคลอมเบีย
  Comoros: คอโมโรส
  Congo: ประเทศคองโก
  Cook Islands: หมู่เกาะคุก
  Costa Rica: คอสตาริกา
  Cote D'ivoire: Cote D'ตดิวัวร์
  Croatia: โครเอเชีย
  Cuba: คิวบา
  Cyprus: ไซปรัส
  Czech Republic: สาธารณรัฐเช็ก
  Denmark: เดนมาร์ก
  Djibouti: จิบูตี
  Dominica: โดมินิกา
  Dominican Republic: สาธารณรัฐโดมินิกัน
  Ecuador: เอกวาดอร์
  Egypt: อียิปต์
  El Salvador: เอลซัลวาดอร์
  Equatorial Guinea: ทอเรียลกินี
  Eritrea: เอริเทรี
  Estonia: เอสโตเนีย
  Ethiopia: สาธารณรัฐเอธิโอเปีย
  Falkland Islands : หมู่เกาะฟอล์คแลนด์
  Faroe Islands: หมู่เกาะแฟโร
  Fiji: ฟิจิ
  Finland: ฟินแลนด์
  France: ฝรั่งเศส
  French Guiana: เฟรนช์เกีย
  French Polynesia: โปลินีเซีฝรั่งเศส
  Gabon: กาบอง
  Gambia: แกมเบีย
  Georgia: จอร์เจีย
  Germany: ประเทศเยอรมัน
  Ghana: กานา
  Gibraltar: ยิบรอลตา
  Greece: กรีก
  Greenland: เกาะกรีนแลนด์
  Grenada: เกรเนดา
  Guadeloupe: ลุป
  Guam: กวม
  Guatemala: กัวเตมาลา
  Guernsey: เสื้อไหมพรม
  Guinea: กินี
  Guinea-bissau: กินีบิสเซา
  Guyana: กายอานา
  Haiti: ไฮติ
  Heard and Mcdonald Islands: ได้ยินและ Mcdonald เกาะ
  Holy See (Vatican City State): พระเห็น (นครรัฐวาติกัน)
  Honduras: ฮอนดูรัส
  Hong Kong: ฮ่องกง
  Hungary: ฮังการี
  Iceland: ประเทศไอซ์แลนด์
  India: อินเดีย
  Indonesia: อินโดนีเซีย
  Iran, Islamic Republic of: อิหร่านสาธารณรัฐอิสลาม
  Iraq: อิรัก
  Ireland: ไอร์แลนด์
  Isle of Man: ไอล์ออฟแมน
  Israel: อิสราเอล
  Italy: อิตาลี
  Jamaica: เกาะจาเมกา
  Japan: ประเทศญี่ปุ่น
  Jersey: นิวเจอร์ซีย์
  Jordan: จอร์แดน
  Kazakhstan: คาซัคสถาน
  Kenya: ประเทศเคนย่า
  Kiribati: ประเทศคิริบาส
  Korea, North: เกาหลี, นอร์ท
  Korea, Republic of: สาธารณรัฐเกาหลี
  Kuwait: คูเวต
  Kyrgyzstan: คีร์กีสถาน
  Laos: สาธารณรัฐประชาธิปไตยประชาชนลาว
  Latvia: ลัตเวีย
  Lebanon: ประเทศเลบานอน
  Lesotho: เลโซโท
  Liberia: ประเทศไลบีเรีย
  Libyan Arab Jamahiriya: สาธารณรัฐสังคมนิยมประชาชนอาหรับลิเบีย
  Liechtenstein: Liechtenstein
  Lithuania: ประเทศลิธัวเนีย
  Luxembourg: ลักเซมเบิร์ก
  Macao: มาเก๊า
  Macedonia: มาซิโดเนีย
  Madagascar: มาดากัสการ์
  Malawi: มาลาวี
  Malaysia: มาเลเซีย
  Maldives: มัลดีฟส์
  Mali: มาลี
  Malta: เกาะมอลตา
  Marshall Islands: หมู่เกาะมาร์แชลล์
  Martinique: มาร์ตินีก
  Mauritania: มอริเตเนีย
  Mauritius: มอริเชียส
  Mayotte: มายอต
  Mexico: เม็กซิโก
  Micronesia: ไมโครนีเซีย
  Moldova: มอลโดวา
  Monaco: โมนาโก
  Mongolia: ประเทศมองโกเลีย
  Montenegro: มอนเตเนโก
  Montserrat: มอนต์เซอร์รัต
  Morocco: โมร็อกโก
  Mozambique: โมซัมบิก
  Myanmar: พม่า
  Namibia: นามิเบีย
  Nauru: นาอูรู
  Nepal: เนปาล
  Netherlands: เนเธอร์แลนด์
  Netherlands Antilles: เนเธอร์แลนด์
  New Caledonia: แคลิโดเนียใหม่
  New Zealand: นิวซีแลนด์
  Nicaragua: ประเทศนิการากัว
  Niger: ประเทศไนเธอร์
  Nigeria: ประเทศไนจีเรีย
  Niue: นีอูเอ
  Norfolk Island: เกาะนอร์โฟล์ค
  Northern Mariana Islands: หมู่เกาะมาเรียนาเหนือ
  Norway: นอร์เวย์
  Oman: โอมาน
  Pakistan: ประเทศปากีสถาน
  Palau: ปาเลา
  Palestinian Territories: ดินแดนปาเลสไตน์
  Panama: ปานามา
  Papua New Guinea: ปาปัวนิวกินี
  Paraguay: ประเทศแพรากเว
  Peru: เปรู
  Philippines: ฟิลิปปินส์
  Pitcairn: พิตแคร์น
  Poland: โปแลนด์
  Portugal: โปรตุเกส
  Puerto Rico: เปอร์โตริโก
  Qatar: กาตาร์
  Reunion: การรวมตัวใหม่
  Romania: โรมาเนีย
  Russian Federation: สหพันธรัฐรัสเซีย
  Rwanda: รวันดา
  Saint Helena: เซนต์เฮเลนา
  Saint Kitts and Nevis: เซนต์คิตส์และเนวิส
  Saint Lucia: เซนต์ลูเซีย
  Saint Pierre and Miquelon: เซนต์ปิแอร์และมีเกอลง
  Saint Vincent : เซนต์วินเซนต์
  Samoa: ซามัว
  San Marino: ซานมารีโน
  Sao Tome and Principe: Sao Tome Principe และ
  Saudi Arabia: ประเทศซาอุดีอาระเบีย
  Senegal: ประเทศเซเนกัล
  Serbia: เซอร์เบีย
  Seychelles: เซเชลส์
  Sierra Leone: เซียร์ราลีโอน
  Singapore: สิงคโปร์
  Slovakia: สโลวะเกีย
  Slovenia: สโลวีเนีย
  Solomon Islands: หมู่เกาะโซโลมอน
  Somalia: โซมาเลีย
  South Africa: แอฟริกาใต้
  Spain: สเปน
  Sri Lanka: ศรีลังกา
  Sudan: ซูดาน
  Suriname: ซูรินาเม
  Svalbard and Jan Mayen: ฟาลบาร์และแจน
  Swaziland: สวาซิแลนด์
  Sweden: สวีเดน
  Switzerland: ประเทศสวิสเซอร์แลนด์
  Syrian Arab Republic: สาธารณรัฐอาหรับซีเรีย
  Taiwan, province of China: ไต้หวัน, จังหวัดของประเทศจีน
  Tajikistan: ทาจิกิสถาน
  Tanzania: ประเทศแทนซาเนีย
  Thailand: ประเทศไทย
  Timor-leste: ติมอร์เลสเต
  Togo: โตโก
  Tokelau: โตเกเลา
  Tonga: ตองกา
  Trinidad and Tobago: ตรินิแดดและโตเบโก
  Tunisia: ตูนิเซีย
  Turkey: ตุรกี
  Turkmenistan: เติร์กเมนิสถาน
  Turks and Caicos : เติกส์และหมู่เกาะเคคอส
  Tuvalu: ตูวาลู
  Uganda: ยูกันดา
  Ukraine: ยูเครน
  United Arab Emirates: สหรัฐอาหรับเอมิ
  United Kingdom: สหราชอาณาจักร
  United States: ประเทศสหรัฐอเมริกา
  Uruguay: อุรุกวัย
  Uzbekistan: อุซเบกิ
  Vanuatu: วานูอาตู
  Venezuela: เวเนซุเอลา
  Vietnam: เวียดนาม
  Virgin Islands, British: หมู่เกาะบริติชเวอร์จิน
  Virgin Islands, U.S.: หมู่เกาะเวอร์จินของสหรัฐอเมริกา
  Wallis and Futuna: วาลลิสและฟุตูนา
  Western Sahara: ซาฮาราตะวันตก
  Yemen: เยเมน
  Zambia: แซมเบีย
  Zimbabwe: ซิมบับเว
