Schedules Menu

  Schedules: ตารางเวลา
  Shows: แสดงตารางการแข่งขัน
  Permissions: กำหนดการสิทธิ์

Schedule

  Show Not Found: แสดงไม่พบ
  Permission Not Found: ไม่พบ Permisison

  Device ID Invalid: ID ผู้เล่นที่ไม่ถูกต้อง
  Start Or End Date Invalid: จุดเริ่มต้นของวันที่สิ้นสุดไม่ถูกต้อง
  User ID Invalid: รหัสผู้ใช้ไม่ถูกต้อง

  Schedule Only One: คุณสามารถกำหนดเวลาเพียงหนึ่งรายการในเวลา
  No Edit Permission: คุณไม่ได้รับอนุญาตให้แก้ไขรายการนี​​้

  Schedule Shows Heading: แสดงตารางการแข่งขัน
  Schedule Shows Instructions: สื่อลากหรือรายการที่จะเล่นบนตารางเวลา แสดงดับเบิลคลิกเพื่อแก้ไข

  Line-In: สายใน
  Schedule Line-In: กำหนดการสายใน

  Schedule Permissions Heading: กำหนดการสิทธิ์
  Schedule Permissions Add Button: เพิ่มการอนุญาต
  Schedule Permissions Instructions: หรือดับเบิลคลิกที่กล่องเพื่อแก้ไข / ลบ

  Schedule For: กำหนดการสำหรับ:

  Details Name: ชื่อ
  Details Owner: เจ้าของ
  Details DateTime: วันที่ / เวลา
  Details Duration: ระยะเวลา
  Details Scheduled By: ตามเวลาที่กำหนดโดย
  Details Scheduled For: ที่กำหนดเวลาไว้สำหรับ
  Details Description: ลักษณะ

  Previous Week: ก่อนหน้า
  Next Week: ถัดไป

  Sunday: ดวงอาทิตย์
  Monday: จันทร์
  Tueday: อังคาร
  Wednesday: แต่งงาน
  Thursday: พฤหัสบดี
  Friday: ศุกร์
  Saturday: กกท.

  January: มกราคม
  February: กุมภาพันธ์
  March: มีนาคม
  April: เมษายน
  May: พฤษภาคม
  June: มิถุนายน
  July: กรกฎาคม
  August: สิงหาคม
  September: กันยายน
  October: ตุลาคม
  November: พฤศจิกายน
  December: ธันวาคม

  DST Spring Ahead: DST ฤดูใบไม้ผลิไปข้างหน้า
  DST Fall Back: DST ฤดูใบไม้ร่วงกลับ

Schedule Edit

  No Timeslots Available: คุณไม่จำเป็นต้องไทม์สลใด ๆ ที่มีอยู่สำหรับสัปดาห์ที่เลือก

  Show Instructions: ในการแสดงที่ถูกต้องไทม์สลเลือกสัปดาห์ที่ต้องการก่อนที่จะจัดตารางเวลา
  Show Heading: แสดงตารางการแข่งขัน

  Line-In: สายใน

  Item Name: ชื่อสินค้า

  Permission Instructions: ให้ข้อมูลบางอย่างเกี่ยวกับตารางเวลานี้
  Permission Heading: กำหนดการอนุญาต

  Permission For: สำหรับการอนุญาต
  Permission Name: ชื่อ

  Timeslot: ตารางเวลา
  Manual Input Option: การป้อนข้อมูลด้วยตนเอง

  Scheduling Mode: โหมดการตั้งเวลา
  One-Time Option: One-Time
  Daily Option: ประจำวัน
  Weekly Option: รายสัปดาห์
  Monthly Option: รายเดือน
  Every X Days Option: X ทุกวัน
  Every X Weeks Option: ทุกสัปดาห์ที่ X
  Every X Months Option: X ทุกเดือน

  Recurring Every: ที่เกิดขึ้นทุกคน
  Start Date: วันที่เริ่มต้น
  Start Time: เวลา

  Duration: ระยะเวลา
  Duration Days: วัน
  Duration Hours: ชั่วโมง
  Duration Minutes: นาที
  Duration Seconds: วินาที

  Recurring Last Date: วันสุดท้ายที่เกิดขึ้นประจำ

  Delete Show Confirm: ลบรายการนี​​้?
  Delete Permission Confirm: ลบการอนุญาตนี้?

  Show Not Found: การแสดงนี้ไม่มีอยู่แล้ว
  Permission Not Found: การอนุญาตนี้ไม่มีอยู่แล้ว
  Duration Not Valid: ระยะเวลาที่ไม่ถูกต้อง

  Required Field Missing: หนึ่งหรือมากกว่าหนึ่งสาขาที่จำเป็นต้องได้รับไม่เต็ม
  Device Not Found: ผู้เล่นนี้ไม่มีอยู่แล้ว

  Item Invalid: รายการที่คุณกำลังพยายามที่จะกำหนดเวลาไม่ถูกต้อง
  Item Does Not Exist: รายการที่คุณกำลังพยายามที่จะกำหนดเวลาไม่ได้อยู่
  User Does Not Exist: ผู้ใช้ที่คุณได้เลือกไม่ได้อยู่
  Device Does Not Exist: ผู้เล่นที่คุณได้เลือกไม่ได้อยู่
  Media Must Be Approved: สื่อจะต้องได้รับการอนุมัติ
  Media Must Not Be Archived: สื่อจะต้องไม่ถูกเก็บไว้
  Scheduling Mode Not Valid: โหมดการตั้งเวลาที่เลือกไม่ถูกต้อง
  Start Date/Time Not Valid: วันที่เริ่มต้น / ครั้งไม่ถูกต้อง
  Stop Date/Time Not Valid: หยุด (ที่ผ่านมา) วันที่ไม่ถูกต้องและต้องมาหลังจากวันที่เริ่มต้นที่ / เวลา
  Recurring Frequency Not Valid: ความถี่ที่เกิดขึ้นไม่ถูกต้อง

  Recurring Show Too Long: ที่เกิดขึ้นแสดงให้เห็นว่าไม่สามารถเป็นเวลานานกว่า 28 วัน
  Daily Show Too Long: การแสดงทุกวันเวลาที่กำหนดไม่สามารถกว่าวัน
  Weekly Show Too Long: แสดงรายสัปดาห์ที่กำหนดไว้ไม่สามารถจะนานกว่าสัปดาห์
  XDay Show Too Long: การแสดงไม่สามารถกว่าความถี่
  XWeek Show Too Long: การแสดงไม่สามารถกว่าความถี่
  Show Conflict: นี้แสดงความขัดแย้งกับคนอื่นในตาราง
  Schedule Permission Required: คุณไม่ได้รับอนุญาตให้กำหนดเวลารายการในเวลาที่กำหนด (s)

  Recurring Permission Too Long: สิทธิ์ที่เกิดขึ้นไม่สามารถเป็นเวลานานกว่า 28 วัน
  Daily Permission Too Long: ได้รับอนุญาตที่กำหนดไว้ในชีวิตประจำวันไม่สามารถกว่าวัน
  Weekly Permission Too Long: ได้รับอนุญาตที่กำหนดไว้ทุกสัปดาห์ไม่สามารถจะนานกว่าสัปดาห์
  XDay Permission Too Long: ได้รับอนุญาตที่กำหนดไว้ไม่สามารถกว่าความถี่
  XWeek Permission Too Long: ได้รับอนุญาตที่กำหนดไว้ไม่สามารถกว่าความถี่
  Permission Conflict: ความขัดแย้งนี้ได้รับอนุญาตอีกด้วยในช่วงเวลาที่


